PlayerID	int	
PlayerTrueName	str	
PlayerTeams	str	
SimpleMin	dec	
SimplePossFor	int	
SimplePossOpp	int	
SimplePointsFor	int	
SimplePointsOpp	int	
SimpleOffRtg	dec	
SimpleDefRtg	dec	
SimpleOverallRtg	dec	
SimpleORebFor	int	
SimpleORebOpp	int	
SimpleDRebFor	int	
SimpleDRebOpp	int	
SimpleORebRate	dec	
SimpleDRebRate	dec	
WeightedMinOffCourt	dec	
WeightedPossForOffCourt	int	
WeightedPossOppOffCourt	int	
WeightedPointsForOffCourt	int	
WeightedPointsOppOffCourt	int	
WeightedOffRtgOffCourt	dec	
WeightedDefRtgOffCourt	dec	
WeightedOverallRtgOffCourt	dec	
WeightedORebForOffCourt	int	
WeightedORebOppOffCourt	int	
WeightedDRebForOffCourt	int	
WeightedDRebOppOffCourt	int	
WeightedORebRateOffCourt	dec	
WeightedDRebRateOffCourt	dec	
WeightedOverallRtgOnCourt	dec	
WeightedORebRateOnCourt	dec	(6)
WeightedDRebRateOnCourt	dec	(6)
WeightedOverallRtgOnCourtMinusOffCourt	dec	
WeightedORebRateOnCourtMinusOffCourt	dec	
WeightedDRebRateOnCourtMinusOffCourt	dec	
AdjustedPM	NULL	
AdjustedPMStdErr	NULL	
